10000000000000000000000000000000000000001
10000000000000000000000000000000000000001
10000000000000000000000000000000000000001
10000000000000000000000000000000000000001
10000000000111000000000000000000000000001
10000000000000000000000000000000000000001
10000000000000000000000000001111110000001
10000000000000000000000100000000000001111
11111111111111111111111111111111111111111
11111111111111111111111111111111111111111