10000000000000000000000000000000000000001
10000000000000000000000000000000000000001
10000000000000000000000000000000000000001
10000000000000000000000000000000000000001
10000000000111000000000000000000000000001
10000000000000110000000000000000000000001
10000000000000000011100000011111111000001
10000000000000000111111110000000000001111
11111111111111111111111111111111111111111
11111111111111111111111111111111111111111