111111111111111111111111111111111111111
111111111111111111111111111111111111111
111111111111111111111111111111111111111
110000000000000000000000000000000000001
110000000000000000000000000000000000001
110000000000000000000000000000000000001
110000000000000000000000011111111000001
110000000000000000000000000000000100001
110000000000000000011000000000000000001
110000000001111111111000000000000000111
111111111111111111111111111111111111111
111111111111111111111111111111111111111
111111111111111111111111111111111111111
111111111111111111111111111111111111111
