111111111111111111111111111
100000000000000001111111111
100000000000000001100000001
100000000000000001100000001
100000000000000001100000001
100000000000000001100000001
100000000000000000000000001
100000000000000000000000000
100000000000000000000000000
100000000000000000000000000
111111111111111111001111111
11111111111111110000000001
11111111000000000000000001
10000000000000000000000001
100000000000000001110000001
10000000000001111110000000110000000
1000000011000000000000
1000000111100000000
1000001000010000000
1000010000001111110000000
1111111111111111111111111111111111111
