110000000000000000000000000000000000000
110000000000000000000000000000000000000
110000000000000000000000000000000000000
110000000000000000000000000000000000000
110000000000000000000000000000000000000
110000000000000000000000000000000000000
110000000000000000000000000000000000000
110000000000000000000000000000000000000
110000000000000000000000000000000000000
110000000001000000000000000000000000000
111111111111111111111111111111111111111
111111111111111111111111111111111111111
111111111111111111111111111111111111111
111111111111111111111111111111111111111
