111000000000000000000000000000000000001
110000000000000000000000000000000000001
110000000000000000000000000000000000001
110000000111100000110000000000000000001
110000000000000000000000000000000000001
111111100000000000000000000000000000001
110011110000000000000000011111111000001
110000000000000000010000000000000100001
110000000001000000011000000000000000001
110000000001111111111000000000000000111
111111111111111111111111111111111111111
111111111111111111111111111111111111111
111111111111111111111111111111111111111
111111111111111111111111111111111111111
111111111111111111111111111111111111111
111111111111111111111111111111111111111
111111111111111111111111111111111111111
111111111111111111111111111111111111111
111111111111111111111111111111111111111
111111111111111111111111111111111111111
111111111111111111111111111111111111111
111111111111111111111111111111111111111